1 1 1 1 1 1 1 1 1 1 1 1 1 1 1 1 1 1 1 1 1 1 1 1 1 1 1 1 1 1 
1 4 6 1 0 0 0 0 0 0 0 0 0 0 0 0 0 0 0 0 0 0 0 0 0 0 0 0 0 1 
1 1 1 0 0 0 0 0 0 0 0 0 0 0 0 0 0 4 4 4 0 0 0 0 0 0 0 0 0 1 
1 0 0 0 0 0 0 0 0 0 0 0 4 4 4 4 4 0 0 0 4 4 4 4 0 0 0 0 0 1 
1 0 0 0 0 0 0 0 0 0 0 4 0 0 0 0 0 0 4 0 0 0 0 0 4 0 0 0 0 1 
1 0 0 0 0 0 0 0 0 0 0 4 0 4 4 4 4 4 0 4 4 4 4 0 0 4 0 0 0 1 
1 0 0 0 0 0 0 0 0 0 0 4 0 4 4 4 1 1 1 1 4 4 2 4 0 0 4 0 0 1 
1 0 0 0 0 0 0 0 0 0 0 4 0 0 0 3 4 0 0 6 1 0 0 0 4 0 4 0 0 1 
1 0 0 0 0 0 0 0 0 0 0 0 4 4 4 4 1 1 1 1 4 0 4 0 4 0 4 0 0 1 
1 0 0 0 0 0 0 0 0 0 0 0 0 0 0 0 4 4 4 4 4 0 4 0 0 0 4 0 0 1 
1 0 0 0 0 0 0 0 0 0 0 0 0 0 0 2 0 0 0 0 0 0 4 4 4 4 4 0 0 1 
1 0 0 0 0 0 0 0 0 0 0 0 0 0 0 0 4 4 4 4 4 4 0 0 0 0 0 0 0 1 
1 0 0 0 0 0 0 0 0 0 0 0 0 0 0 0 0 0 0 0 0 0 0 0 0 0 0 0 0 1 
1 0 0 0 0 0 0 0 0 0 0 0 0 0 0 0 0 0 0 0 0 0 0 0 0 0 0 0 0 1 
1 1 1 1 1 1 1 1 1 1 1 1 1 1 1 1 1 1 1 1 1 1 1 1 1 1 1 1 1 1 
