1 1 1 1 1 1 1 1 1 1 1 1 1 1 1 1 1 1 1 1 1 1 1 1 1 1 1 1 1 0 
1 4 2 2 2 2 2 1 2 2 2 2 2 2 6 2 2 2 2 2 2 1 2 2 2 2 2 5 1 0 
1 2 2 1 2 2 2 2 1 2 2 1 2 1 2 1 2 1 2 2 1 2 2 2 2 1 2 2 1 0 
1 2 1 7 1 2 1 2 2 1 2 2 1 2 2 2 1 2 2 1 2 2 1 2 1 7 1 2 1 0 
1 2 2 1 2 2 2 1 2 2 1 2 2 1 2 1 2 2 1 2 2 1 2 2 2 1 2 2 1 0 
1 2 2 2 2 1 2 2 2 2 2 1 2 2 2 2 2 1 2 2 2 2 2 1 2 2 2 2 1 0 
1 2 2 1 2 2 2 1 2 1 1 2 1 2 2 2 1 2 1 1 2 1 2 2 2 1 2 2 1 0 
1 6 1 7 1 2 2 2 2 2 2 2 2 2 3 2 2 2 2 2 2 2 2 2 1 7 1 6 1 0 
1 2 2 1 2 2 2 1 2 1 1 2 1 2 2 2 1 2 1 1 2 1 2 2 2 1 2 2 1 0 
1 2 2 2 2 1 2 2 2 2 2 1 2 2 2 2 2 1 2 2 2 2 2 1 2 2 2 2 1 0 
1 2 2 1 2 2 2 1 2 2 1 2 2 1 2 1 2 2 1 2 2 1 2 2 2 1 2 2 1 0 
1 2 1 7 1 2 1 2 2 1 2 2 1 2 2 2 1 2 2 1 2 2 1 2 1 7 1 2 1 0 
1 2 2 1 2 2 2 2 1 2 2 1 2 1 2 1 2 1 2 2 1 2 2 2 2 1 2 2 1 0 
1 5 2 2 2 2 2 1 2 2 2 2 2 2 6 2 2 2 2 2 2 1 2 2 2 2 2 4 1 0 
1 1 1 1 1 1 1 1 1 1 1 1 1 1 1 1 1 1 1 1 1 1 1 1 1 1 1 1 1 0 
