1 1 1 1 1 1 1 1 1 1 1 1 1 1 1 1 1 1 1 1 1 1 1 1 1 1 1 1 1 1 
1 2 2 2 2 2 2 2 2 2 2 2 2 2 2 2 2 2 2 2 2 2 2 2 2 2 2 2 2 1 
1 2 1 1 1 1 1 1 1 1 1 1 1 1 1 1 1 1 1 1 1 1 1 1 1 1 1 1 1 1 
1 2 2 2 2 1 2 2 2 1 2 2 2 2 2 2 2 2 2 2 1 2 2 2 2 2 2 2 2 1 
1 2 1 1 2 1 2 1 2 1 2 1 1 1 1 1 1 1 1 2 1 2 1 1 1 1 1 1 2 1 
1 2 1 2 2 1 2 1 2 1 2 1 2 2 2 2 2 2 1 2 1 2 1 6 2 2 2 1 2 1 
1 2 1 1 2 1 2 1 2 1 2 1 2 1 1 1 1 2 1 2 1 2 1 2 1 1 2 1 2 1 
1 2 2 1 2 1 2 1 2 1 2 1 2 1 3 2 1 2 1 2 1 2 1 2 4 2 2 1 2 1 
1 2 1 1 2 1 2 1 2 1 2 1 2 1 1 2 1 2 1 2 1 2 1 1 1 1 2 1 2 1 
1 2 2 1 2 1 2 1 2 1 2 1 2 2 2 2 1 2 1 2 1 2 2 2 2 2 2 1 2 1 
1 2 1 1 2 1 2 1 2 1 2 1 1 1 1 1 1 2 1 2 1 1 1 1 1 1 1 1 2 1 
1 2 1 2 2 1 2 1 2 1 2 2 2 2 2 2 2 2 1 2 1 2 2 2 2 2 2 2 2 1 
1 2 1 1 2 1 2 1 2 1 1 1 1 1 1 1 1 1 1 4 1 2 1 1 1 1 1 1 1 1 
1 2 1 2 2 2 2 1 2 2 2 2 2 2 2 2 5 2 6 1 1 2 2 2 2 2 2 2 5 1 
1 1 1 1 1 1 1 1 1 1 1 1 1 1 1 1 1 1 1 1 1 1 1 1 1 1 1 1 1 1 
