1 1 1 1 1 1 1 1 1 1 1 1 1 1 1 1 1 1 1 1 1 1 1 1 1 1 1 1 1 1 
1 1 2 0 0 0 0 0 0 1 0 0 0 0 2 0 0 0 0 1 0 0 0 0 0 0 2 1 1 1 
1 2 6 0 1 1 0 0 1 2 0 0 1 1 0 1 1 0 0 2 1 0 0 1 1 0 6 2 1 1 
1 0 0 1 2 0 0 1 2 0 1 0 0 0 0 0 0 0 1 0 2 1 0 0 2 1 0 0 1 1 
1 0 1 2 0 1 0 0 0 0 0 0 1 0 1 0 1 0 0 0 0 0 0 1 0 2 1 0 1 1 
1 0 0 0 1 0 0 0 0 1 0 1 0 0 0 0 0 1 0 1 0 0 0 0 1 0 0 0 1 1 
1 0 1 0 1 0 0 1 0 1 0 0 0 1 2 1 0 0 0 1 0 1 0 0 1 0 1 0 1 1 
1 2 1 6 2 1 0 1 0 2 0 1 0 2 3 2 0 1 0 2 0 1 0 1 2 6 1 2 1 1 
1 0 1 0 1 0 0 1 0 1 0 0 0 1 2 1 0 0 0 1 0 1 0 0 1 0 1 0 1 1 
1 0 0 0 1 0 0 0 0 1 0 1 0 0 0 0 0 1 0 1 0 0 0 0 1 0 0 0 1 1 
1 0 1 2 0 1 0 0 0 0 0 0 1 0 1 0 1 0 0 0 0 0 0 1 0 2 1 0 1 1 
1 0 0 1 2 0 0 1 2 0 1 0 0 0 0 0 0 0 1 0 2 1 0 0 2 1 0 0 1 1 
1 2 6 0 1 1 0 0 1 2 0 0 1 1 0 1 1 0 0 2 1 0 0 1 1 0 6 2 1 1 
1 1 2 0 0 0 0 0 0 1 0 0 0 0 2 0 0 0 0 1 0 0 0 0 0 0 2 1 1 1 
1 1 1 1 1 1 1 1 1 1 1 1 1 1 1 1 1 1 1 1 1 1 1 1 1 1 1 1 1 1 
