1 1 1 1 1 1 1 1 1 1 1 1 1 1 1 1 1 1 1 1 1 1 1 1 1 1 1 1 1 1 
1 0 0 0 0 0 0 0 0 0 0 0 0 1 2 5 2 1 0 0 0 0 0 0 0 0 0 0 0 1 
1 0 0 0 0 0 0 0 0 0 0 0 0 1 2 1 2 1 0 0 0 0 0 0 0 0 0 0 0 1 
1 0 0 0 1 1 1 1 1 1 0 0 0 1 2 6 2 1 0 0 0 1 1 1 1 1 0 0 0 1 
1 0 0 1 2 2 2 2 2 2 1 0 0 0 1 2 1 0 0 0 1 2 2 2 2 2 1 0 0 1 
1 0 1 2 2 1 1 1 1 2 2 1 0 0 1 2 1 0 0 1 2 2 1 1 1 2 2 1 0 1 
1 1 2 2 1 0 0 0 0 1 2 1 1 1 1 2 1 1 1 1 2 1 0 0 0 1 2 2 1 1 
1 4 6 1 0 0 0 0 0 1 2 2 2 2 2 3 2 2 2 2 2 1 0 0 0 0 1 6 4 1 
1 1 2 2 1 0 0 0 0 1 0 1 1 1 1 2 1 1 1 1 2 1 0 0 0 1 2 2 1 1 
1 0 1 2 2 1 1 1 1 2 2 1 0 0 1 2 1 0 0 1 2 2 1 1 1 2 2 1 0 1 
1 0 0 1 2 2 2 2 2 2 1 0 0 0 1 2 1 0 0 0 1 2 2 2 2 2 1 0 0 1 
1 0 0 0 1 1 1 1 1 1 0 0 0 1 2 6 2 1 0 0 0 1 1 1 1 1 0 0 0 1 
1 0 0 0 0 0 0 0 0 0 0 0 0 1 2 1 2 1 0 0 0 0 0 0 0 0 0 0 0 1 
1 0 0 0 0 0 0 0 0 0 0 0 0 1 2 5 2 1 0 0 0 0 0 0 0 0 0 0 0 1 
1 1 1 1 1 1 1 1 1 1 1 1 1 1 1 1 1 1 1 1 1 1 1 1 1 1 1 1 1 1 
