1 1 1 1 1 1 1 1 1 1 1 1 1 1 1 1 1 1 1 1 1 1 1 1 1 1 1 1 1 1 
1 2 2 2 2 2 2 2 2 2 2 2 2 2 2 2 2 2 2 2 2 2 2 2 2 2 2 2 2 1 
1 2 2 2 2 2 2 2 2 2 2 2 2 2 1 1 1 2 2 2 2 2 2 2 2 2 2 2 2 1 
1 2 2 2 2 2 2 2 2 2 2 2 1 1 0 6 0 1 1 2 2 2 2 2 2 2 2 2 2 1 
1 2 2 2 2 2 2 2 2 2 2 1 6 0 1 0 1 0 6 1 2 2 2 2 2 2 2 2 2 1 
1 2 2 2 2 2 2 2 2 2 2 1 0 0 1 1 1 0 0 1 2 2 2 2 2 2 2 2 2 1 
1 2 2 2 2 2 2 2 2 2 1 0 1 1 7 7 7 1 1 0 1 2 2 2 2 2 2 2 2 1 
1 2 2 2 2 2 2 2 2 2 1 6 0 1 7 3 7 1 0 6 1 2 2 2 2 2 2 2 2 1 
1 2 2 2 2 2 2 2 2 2 1 0 1 1 7 7 7 1 1 0 1 2 2 2 2 2 2 2 2 1 
1 2 2 2 2 2 2 2 2 2 2 1 0 0 1 1 1 0 0 1 2 2 2 2 2 2 2 2 2 1 
1 2 2 2 2 2 2 2 2 2 2 1 6 0 1 0 1 0 6 1 2 2 2 2 2 2 2 2 2 1 
1 2 2 2 2 2 2 2 2 2 2 2 1 1 0 6 0 1 1 2 2 2 2 2 2 2 2 2 2 1 
1 2 2 2 2 2 2 2 2 2 2 2 2 2 1 1 1 2 2 2 2 2 2 2 2 2 2 2 2 1 
1 2 2 2 2 2 2 2 2 2 2 2 2 2 2 2 2 2 2 2 2 2 2 2 2 2 2 2 2 1 
1 1 1 1 1 1 1 1 1 1 1 1 1 1 1 1 1 1 1 1 1 1 1 1 1 1 1 1 1 1 
