1 1 1 1 1 1 1 1 1 1 1 1 1 1 1 1 1 1 1 1 1 1 1 1 1 1 1 1 1 1 
1 6 1 1 2 1 2 2 2 1 2 2 2 2 2 1 2 2 2 2 2 2 2 1 2 2 2 2 2 1 
1 2 2 2 2 2 2 1 2 2 2 1 2 1 2 1 2 1 2 1 2 2 1 6 1 2 2 1 2 1 
1 2 1 1 2 1 1 1 1 1 2 1 2 1 2 1 2 2 1 2 2 1 2 2 2 1 2 2 1 1 
1 2 1 1 2 1 2 2 2 1 2 1 2 1 2 1 2 1 2 1 2 2 2 1 2 2 2 1 2 1 
1 2 1 1 2 1 2 1 2 2 2 1 2 2 2 1 2 2 2 2 2 1 2 2 2 1 2 2 2 1 
1 2 2 2 2 1 2 1 1 1 1 1 2 1 1 1 1 1 2 1 2 2 1 2 1 2 2 1 2 1 
1 1 1 2 1 1 5 2 2 2 2 2 2 1 5 3 4 1 2 2 1 2 2 4 2 2 1 2 2 1 
1 2 2 2 2 1 2 1 1 1 1 1 2 1 1 1 1 1 2 1 2 2 1 2 1 2 2 1 2 1 
1 2 1 2 1 1 2 1 2 2 2 2 2 2 2 1 2 2 2 2 2 1 2 2 2 1 2 2 2 1 
1 2 1 2 2 2 2 1 2 1 1 2 1 1 2 1 2 1 2 1 2 2 2 1 2 2 2 1 2 1 
1 2 2 1 1 1 1 1 2 2 2 2 2 1 2 1 2 2 1 2 2 1 2 2 2 1 2 2 1 1 
1 1 2 2 2 1 2 2 2 1 2 1 2 1 2 1 2 1 2 1 2 2 1 6 1 2 2 1 2 1 
1 6 2 1 2 2 2 1 2 2 2 2 2 2 6 1 2 2 2 2 2 2 2 1 2 2 2 2 2 1 
1 1 1 1 1 1 1 1 1 1 1 1 1 1 1 1 1 1 1 1 1 1 1 1 1 1 1 1 1 1 
