1 1 1 1 1 1 1 1 1 1 1 1 1 1 1 1 1 1 1 1 1 1 1 1 1 1 1 1 1 1 
1 0 2 0 1 1 1 6 1 1 5 2 2 2 1 1 1 2 2 2 2 2 2 2 2 2 2 2 4 1 
1 2 1 2 2 2 0 2 0 0 0 1 1 1 1 1 1 1 1 2 1 1 1 1 1 1 1 2 1 1 
1 2 1 2 1 1 2 1 2 1 0 0 0 2 2 0 1 0 0 2 0 2 0 2 0 2 0 0 6 1 
1 2 1 2 1 1 2 1 2 1 1 2 1 1 1 2 1 0 1 1 1 2 1 1 1 1 0 1 0 1 
1 0 2 0 2 1 0 1 2 0 2 0 0 2 2 2 2 2 2 2 2 2 2 2 1 1 2 1 2 1 
1 1 1 1 2 2 0 2 0 2 1 1 2 1 1 1 0 1 1 1 0 1 1 1 1 1 0 1 2 1 
1 3 0 0 2 1 2 1 1 1 1 2 2 1 0 1 0 0 0 1 2 2 2 2 2 0 2 0 0 1 
1 1 1 1 2 1 2 0 2 2 2 2 6 1 2 1 0 2 1 1 2 1 1 1 1 0 1 2 1 1 
1 4 1 1 2 1 2 1 1 1 0 1 2 1 0 0 2 0 0 2 0 2 2 2 2 0 1 0 0 1 
1 2 2 0 2 2 2 0 1 2 0 1 2 0 0 1 0 1 1 1 0 1 1 1 1 0 1 1 2 1 
1 2 1 2 1 1 2 0 1 2 0 1 1 1 1 5 2 0 1 0 0 2 2 2 2 0 2 2 0 1 
1 2 1 2 1 1 2 1 1 1 0 1 0 2 0 1 0 2 1 0 1 1 1 1 0 1 1 1 0 1 
1 2 2 0 2 2 2 0 2 0 0 6 0 1 0 2 0 2 0 2 2 2 2 2 2 2 2 2 6 1 
1 1 1 1 1 1 1 1 1 1 1 1 1 1 1 1 1 1 1 1 1 1 1 1 1 1 1 1 1 1 
